1111111111111
100E100000C01
100000C100000
11000000000P1
1111111111111
