1111111111111
1111000000001
1C100000000P1
100000P000E01
1111111111111
